0000000000000
1111111100000
1010101010101
1111111100000
1010101010101
1111111100000
1010101010101