000000000000
033300011000
032100011000
033300000000
000000000000
000000000000
000222003330
000212003230
000222003330
000000000000
000000000000
001100022200
001100022200
000000000000
000000000000
000000000000
000000000000
000000000000
000000000000
000000000000
000000000000
000000000000
000000000000
000000000000
000000000000
000000000000