333333333333
222222222222
111111111111
333333333333
222222222222
111111111111
333333333333
222222222222
000000000000
000000000000
000000000000
000000000000
000000000000
000000000000
000000000000
000000000000
000000000000
000000000000
000000000000
000000000000
000000000000
000000000000
000000000000
000000000000
000000000000
000000000000