000000000000
000000000000
000033330000
003322223300
033211112330
332111111233
332111111233
033222222330
003300003300
000300003000
000000000000
000000000000
011000000110
000000000000
001100001100
000000000000
000110011000
000000000000
000011110000
000000000000
000000000000
000000000000
000000000000
000000000000
000000000000
000000000000