333333333333
311100001113
311100001113
311100001113
311122221113
311122221113
311122221113
311100001113
311100001113
333333333333
000000000000
000000000000
000000000000
000000000000
000000000000
000000000000
000000000000
000000000000
000000000000
000000000000
000000000000
000000000000
000000000000
000000000000
000000000000
000000000000