123321123321
231132231132
312213312213
123321123321
231132231132
312213312213
123321123321
231132231132
312213312213
123321123321
000000000000
000000000000
000000000000
000000000000
000000000000
000000000000
000000000000
000000000000
000000000000
000000000000
000000000000
000000000000
000000000000
000000000000
000000000000
000000000000